# # # # # # # # # # # # # # # # #
# ~ . . # . . . # . . # . # . . #
# # # # # . # # # . . . . # . # #
# . . . . ~ ~ ~ # . . # . . . * #
# . # # # ~ # . # . # . # . # * #
# . # . # ~ # . . . # . # . # * #
# . # . # ~ # . # . . # # . # . #
# . # . . ~ # . # # . # . # . . #
# * . . # # # . ~ # . . . . . # #
# * * * * . . . # # . # # . . . #
# # # # . # . . . # . # . . # . #
# . . . . # . # . . . # # . # . #
# . # # . # . # . # . . . . . . #
# # # # # # # # # # # # # # # # #
