# # # # # # # # # # # # # # # # # # # # # # # # # #
# . . . . # * * * . . . ~ ~ ~ # . * * * * . . . . #
# . # # # # # # . . . ~ ~ . # # # # # . # # # # . #
# . . . ~ . # . # . . . * * . . # . . . * . # # . #
# # # # * # . # ~ # # # # . # # # # # . . * * . . #
# ~ ~ * . # . # * * * * * . . . . . # . # # # * . #
# . # # . # # # ~ # . # . . * . . # . # ~ ~ . # . #
# . # # . . . ~ . . . . . ~ * . . # # # * * . # . #
# . * . . . # # # . # # # # # . * * . ~ ~ . . . # #
# # # . # * # . * * . . . * ~ . . . * * # # # . ~ #
# . ~ ~ ~ ~ . # . . * # . # . . # . # . . * # # # #
# # # # . # # . # . ~ # # * * # # . . # . # ~ . . #
# . * * ~ ~ ~ # . # . . . . . . . # ~ . * . . . # #
# * # # # # . # . # ~ ~ # . # . # . . * # . # # . #
# # # * * . . . * . . ~ ~ * * * . . . . . . . # # #
# * # . # . ~ . # . . * * * ~ * # # # * # . # . # #
# # # # # # # # # # # # # # # # # # # # # # # # # #
