# # # # # # # # # # # # # # # # #
# ~ . . # . . . . . # # . # . ~ #
# # # # # . # # # # # . . ~ # . #
# . . . # ~ ~ ~ ~ # # # # . . * #
# . # . # ~ # . # . # ~ # . # * #
# . # . . ~ # . # . # . . ~ # * #
# . # . # ~ # . # . # # # . # . #
# . # # # ~ # # # # . . . . . . #
# * . # # # # . ~ # . # # # . # #
# * * * * # # . # . . # . # # ~ #
# # # # . # . . . * # # . . # ~ #
# . . . . . . # . * . # # . # # #
# . # # . # . # . # . . . . . . #
# # # # # # # # # # # # # # # # #
