# # # # # # # # # # # # # # # # #
# ~ . . # . . . . . . # . # . . #
# # # # # . # # # . . . . # . # #
# . . . . . . . . . . # . . . * #
# . # # # . # . # . # . # . # * #
# . # . # . # . # . # . # . # * #
# . # . # . # . # . . # # . # . #
# . # . . . . . # # . # . # . . #
# * . . # # # . . . . . . . . # #
# * * * * . . . # # . # # . . . #
# # # # . # . . . # . # . . # . #
# . . . . # . # . . . # # . # . #
# . # # . # . # . # . . . . . . #
# # # # # # # # # # # # # # # # #
