# # # # # # # # # # # # # # # # # # # # # # # # # #
# . . . . # . . . . . . . . # . . . . . . . . . . #
# . # # # # # # . . . . . # # # # # . # # # # # . #
# . . . . . . # . # . . . . . . # . . . . . # # . #
# # # # . # . # . # . # # # # . # # # # # . . . . #
# . . . . # . # . . . . . . . . . . . # . # # # . #
# . # # . # # # . # . # . . . . . # . # . . . # . #
# . # # . . . . . . . . . . . . . # # # . . . # . #
# . . . . . # # # . # # # # # . . . . . . . . . # #
# # # . # . # . . . . . . . . . . . . . # # # . . #
# . . . . . . . # . . . . # . . # . # . . . # # # #
# # # # . # # . # . . # # # . # # . . # . # . . . #
# . . . . . . . # . # . . . . . . . # . . . . . # #
# . # # # # . # . # . . # . # . # . . . # . # # . #
# # # . . . . . . . . . . . . . . . . . . . . # # #
# . # . # . . . # . . . . # . . . . # # # . # . # #
# # # # # # # # # # # # # # # # # # # # # # # # # #
