# # # # # # # # # # # # # # # # # #
# . . . # . . ~ . . . . . . # . # #
# . # . # # # . . . # # # . . . # #
# ~ # . . . # # # . . . # # . . # #
# ~ # # ~ # # . . . . # # . . # # #
# . . # . # # # . . . . # # . . # #
# . . # # # # . . . # # . . . # # #
# # # # . . . . # # # . . . # # # #
# # . # # . . . . . # # . . . # . #
# . . . # . . . . # # # . # . # . #
# . # . # . # . . # # # . # . # . #
# . # . # . . # . # . . . # . . . #
# # # . . . . # # # . # # . . # # #
# # # # # # # # # # # # # # # # # #
